# # # # # # . . . . . . . . . # # # # #
# . . . . . . . . . . . . . . . . . . #
# . . . . . . . . . . . . . . . . . . #
# . . . . . . . . . . . . . . . . . . #
# . . . . . . . . . . . . . . . . . . #
# . . . . . . . . . . . . . . . . . . #
# . . . . . . . . . . . . . . . . . . #
# . . . . . . . . . . . . . . . . . . #
. . . . . . . . # # # # # . . . . . . .
. . . . . . . . # # # # # . . . . . . .
. . . . . . . . # # # # # . . . . . . .
. . . . . . . . # # # # # . . . . . . .
. . . . . . . . . . . . . . . . . . . .
# . . . . . . . . . . . . . . . . . . #
# . . . . . . . . . . . . . . . . . . #
# . . . . . . . . . . . . . . . . . . #
# . . . . . . . . . . . . . . . . . . #
# . . . . . . . . . . . . . . . . . . #
# . . . . . . . . . . . . . . . . . . #
# # # # # # . . . . . . . . . # # # # #
 >
# # # # # # . . . . . . . . . # # # # #
# . . . . . . . . . . . . . . . . . . #
# . . . . . . . . . . . . . . . . . . #
# . . . . . . . . . . . . . . . . . . #
# . . . . . . . . . . . . . . . . . . #
# . . . . . . . . . . . . . . . . . . #
# . . . . . . . . . . . . . . . . . . #
# . . . . . . . . . . . . . . . . . . #
. . . . . . . . + + + + + . . . . . . .
. . . . . . . . + + + + + . . . . . . .
. . . . . . . . + + + + + . . . . . . .
. . . . . . . . + + + + + . . . . . . .
. . . . . . . . . . . . . . . . . . . .
# . . . . . . . . . . . . . . . . . . #
# . . . . . . . . . . . . . . . . . . #
# . . . . . . . . . . . . . . . . . . #
# . . . . . . . . . . . . . . . . . . #
# . . . . . . . . . . . . . . . . . . #
# . . . . . . . . . . . . . . . . . . #
# # # # # # . . . . . . . . . # # # # #
 >
# # # # # # # . . . . . . # # # # # # #
# # # # # . . . . . . . . . . # # # # #
# # # # # . . . . . . . . . . # # # # #
# # # # # . . . # # # # . . . # # # # #
# . . . . . . . # # # # . . . . . . . #
# . . . . . . . # # # # . . . . . . . #
# . . . . . . . . . . . . . . . . . . #
# . . . . . . . . . . . . . . . . . . #
. . . # . . . . . . . . . . . . # . . .
. . . # . . . . . . . . . . . . # . . .
. . . # . . . . . . . . . . . . # . . .
. . . # . . . . . . . . . . . . # . . .
. . . . . . . . . . . . . . . . . . . #
# . . . . . . . . . . . . . . . . . . #
# . . . . . . . # # # # . . . . . . . #
# . . . . . . . # # # # . . . . . . . #
# # # # # . . . # # # # . . . # # # # #
# # # # # . . . . . . . . . . # # # # #
# # # # # . . . . . . . . . . # # # # #
# # # # # # # . . . . . . # # # # # # #
 >
# # # # # # # . . . . . . # # # # # # #
# + + + + . . . . . . . . . . + + + + #
# + + + + . . . . . . . . . . + + + + #
# + + + + . . . # # # # . . . + + + + #
# . . . . . . . # # # # . . . . . . . #
# . . . . . . . # # # # . . . . . . . #
# . . . . . . . . . . . . . . . . . . #
# . . . . . . . . . . . . . . . . . . #
. . . # . . . . . . . . . . . . # . . .
. . . # . . . . . . . . . . . . # . . .
. . . # . . . . . . . . . . . . # . . .
. . . # . . . . . . . . . . . . # . . .
. . . . . . . . . . . . . . . . . . . #
# . . . . . . . . . . . . . . . . . . #
# . . . . . . . # # # # . . . . . . . #
# . . . . . . . # # # # . . . . . . . #
# # # # # . . . # # # # . . . # # # # #
# # # # # . . . . . . . . . . # # # # #
# # # # # . . . . . . . . . . # # # # #
# # # # # # # . . . . . . # # # # # # #
 >
# # # # # # . . . . . . . . . # # # # #
# . . . . . . . . . . . . . . . . . . #
# . . . . . . . . . . . . . . . . . . #
# . . . . . . . . . . . . . . . . . . #
# . . . . . . . . . . . . . . . . . . #
# . . . . . . . . . . . . . . . . . . #
# . . . . . . . . # # . . . . . . . . #
# . . . . . . . . # # . . . . . . . . #
. . . . . . . . . . . . . . . . . . . .
. . . . . . . . . # # . . . . . . . . .
. . . . . . . . . # # . . . . . . . . .
. . . . . . . . . . . . . . . . . . . .
. . . . . . . . . # # . . . . . . . . .
# . . . . . . . . # # . . . . . . . . #
# . . . . . . . . . . . . . . . . . . #
# . . . . . . . . . . . . . . . . . . #
# . . . . . . . . . . . . . . . . . . #
# . . . . . . . . . . . . . . . . . . #
# . . . . . . . . . . . . . . . . . . #
# # # # # # . . . . . . . . . # # # # #